5222222222222222222222222222222222222226
1YYYYYYYYYYYYYYYYYYYYYYYYYYYYYYYYYYYYYY3
1YY0000000000000000000000000000000000YY3
1Y3                                  1Y3
1Y3                      B           1Y3
1Y3                  9XXXV           1Y3
1Y3    B       B                     1Y3
1Y3                                  1Y3
1Y3               9XXXV              1Y3
1Y3                                  1Y3
1Y3 P   U  M U                     B 1Y3
1YY22222Y2222Y222222222226  M 5226   1Y3
1YYYYYYYYYYYYYYYYYYYYYYYYY2222YYY3   1Y3
1YY0000000000000000000000000000007   1Y3
1Y3                                  1Y3
1Y3                                 5YY3
1Y3                5XXXXV   B       1YY3
1Y3         B     57                1YY3
1Y3              57            5V   1YY3
1Y3   B         57    5XXXXXXXX7   5YYY3
1Y3            57     W            1YYY3
1Y3 E         53 M   53            1YYY3
1YY22222222222YY22222Y3 M  52222222YYYY3
1YYYYYYYYYYYYYYYYYYYYYY2222YYYYYYYYYYYY3
4000000000000000000000000000000000000007
