522222222222222222222222222226
1YYYYYYYYYYYYYYYYYYYYYYYYYYYY3
1YY000000000000000000000000YY3
1Y3                        1Y3
1Y3                        1Y3
1Y3                        1Y3
1Y3       B                1Y3
1Y3                   B    1Y3
1Y3    9XXXV   9XXXV       1Y3
1Y3                        1Y3
1Y3                        1Y3
1Y3  P                  E  1Y3
1YY222222222222222222222222YY3
1YYYYYYYYYYYYYYYYYYYYYYYYYYYY3
400000000000000000000000000007
